ahhhhhhhhhhhhhe
#  o o o o o  X
# |||o|||o||| X
#o| o o o o |oX
# |o|||o|||o| X
#ooo|     |oooX
# |o|  o  |o| X
#ooo|     |oooX
# |o|||o|||o| X
#o| o o o o |oX
# |||o|||o||| X
#  o o o o o  X
bbbbbbbbbbbbbbb
