ahhhhhhhhhhhhhe
#  o o o o o  X
# |o|o|||o|o| X
#oo o o o o ooX
#o|o|||o|||o|oX
#oo o o o o ooX
# |o| |o| |o| X
#oo o o o o ooX
#o|o|||o|||o|oX
#oo o o o o ooX
# |o|o|||o|o| X
#  o o o o o  X
bbbbbbbbbbbbbbb
