ahhhhhhhhhhhhhe
#  o o o o o  X
# |||o|||o||| X
#o| o o o o |oX
# oo|||o|||oo X
#o| |     | |oX
#o|o| |o| |o|oX
#o| |     | |oX
# oo|||o|||oo X
#o| o o o o |oX
# |||o|||o||| X
#  o o o o o  X
bbbbbbbbbbbbbbb
